M0###000#######
00#0000000000##
#000#000#000#0#
0000##000000000
###000###000###
#0000##000000##
###0000###000##
00####00#000###
####000##00##00
##00000##000##0
#00##0000###00#
g0###00###00#0#
